111111111111111111
101000000000000011
100010001001001011
101000000P000C0101
1000C0000001010101
100001110010010001
100000010C10001011
110000001001100001
101000000000000011
111000001001100011
1010C000C0000000C1
111001100010000001
10000E000011010101
110E00001C00000011
100001000C10100011
100010010011000101
101000101C00010001
101100001000110001
11010100001P01C001
101011000C00C00001
100000011100000111
111111111111111111