1111111111
1000000001
1000000001
1000M00001
1000P00001
1000M00001
1000000001
1000000001
1E000000C1
1111111111